******************++++******************
*                                      *
*                      ***             *
*                                      *
*                                      *
*                                      *
*                                      *
*                                      *
*               *                      *
*                                      *
+             *                        +
+                                      +
+                                      +
+                                      +
*                                      *
*                                      *
*                                      *
*                                      *
*                                      *
*                                      *
*                                      *
*                                      *
*                                      *
****************************************
