**********************++****
*                          *
*                          *
*                          *
*                          *
*                          *
*                          *
*                          *
*                          *
*                          *
*                          *
*                          *
*                          *
*                          *
*                          *
*   ****                   *
*                          *
*                          *
*                          *
*                          *
*                          *
*                          *
*       ***                *
*                          *
*                          *
*                          *
*                          *
*                          *
****************************