****************************************
*                                      *
*                      ***             *
*                                      *
*                             **********
*                                      *
**************************             *
*                                      *
*                             **********
*                                      *
*                                      +
*                                      +
*                                      +
*                                      +
*                     *                *
*                      *               *
*                       *              *
*                        *             *
*                         *            *
*                          *           *
*                           *          *
*                            *         *
*                             *        *
******************++++******************
