****************************************
*            *            *            *
*            *            *            *
*            *            *            *
*            *            *            *
*            *            *            *
*                                      *
*                                      *
*                                      *
*                                      *
*                                      *
*                                      *
*                                      *
*                                      *
*                                      *
*                                      *
*                                      *
*                                      *
*                                      *
*                                      *
*                                      *
*                                      *
*                                      *
******************++++******************