****************************************
*                                      *
*                      ***             *
*                                      *
*                             **********
*                                      *
*                                      *
*                                      *
*                             **********
*                                      *
+                                      +
+                                      +
+     *************                    +
+                                      +
*                       ****************
*                                      *
*            ***********               *
*                                      *
*                                      *
*                                      *
*                                      *
*                                      *
*                                      *
******************++++******************
