******************++++******************
*                                      *
*                      ***             *
*                                      *
*                                      *
*                                      *
*                                      *
*                                      *
*               *                      *
*                                      *
+             *                        *
+                              *       *
+                             *        *
+                            *         *
*                           *          *
*                          *           *
*            ***************************
*                                      *
*                                      *
*                                      *
*                                      *
*                                      *
*                                      *
****************************************
