******************++++******************
*                                      *
*                      ***             *
*                                      *
*                             **********
*                                      *
**************************             *
*                                      *
*                             **********
*                                      *
+                                      *
+                                      *
+                                      *
+                     +                *
*                    +                 *
*                   +                  *
*                  +                   *
*                 +                    *
*                +                     *
*               +                      *
*              +                       *
*             +                        *
*            +                         *
******************++++******************
