******************++++******************
*                                      *
*                      ***             *
*                                      *
*                             **********
*                                      *
**************************             *
*                                      *
*                             **********
*                                      *
+                                      +
+                                      +
+                                      +
+                                      +
*                                      *
*                                      *
*                                      *
*                                      *
*                                      *
*                                      *
*                                      *
*                                      *
*                                      *
******************++++******************
