****************************************
*                                      *
*                                      *
*                                      *
*                                      *
*                                      *
*                                      *
*                                      *
*                                      *
*******                                *
*      *                               *
*       *                              *
*      *                               *
*******                                *
*                                      *
*                                      *
*                                      *
*                                      *
*                                      *
*                                      *
*                                      *
*                                      *
*                                      *
******************++++******************
