******************++++******************
*                                      *
*                                      *
*                                      *
*                                      *
*                                      *
*                                      *
*                                      *
*                                      *
*                                      *
*                                      +
*                                      +
*                                      +
*                                      +
*                                      *
*                                      *
*                                      *
*                                      *
*                                      *
*                                      *
*                                      *
*                                      *
*                                      *
****************************************
