******************++++******************
*                                      *
*                                      *
*                                      *
*******************                    *
*                 *                    *
*                 *                    *
*                 *                    *
*                 *                    *
*                 *                    *
+                 *                    *
+                 **************       *
+                                      *
+                    *******************
*                                      *
*                                      *
*                                      *
*                                      *
*                                      *
*                                      *
*                                      *
*                                      *
*                                      *
******************++++******************
