******************++++******************
*                                      *
*                                      *
*                                      *
*                                      *
*                                      *
*                                      *
*                                      *
*                                      *
*******                                *
*      *                               +
*       *                              +
*      *                               +
*******                                +
*                                      *
*                                      *
*                                      *
*                                      *
*                                      *
*                                      *
*                                      *
*                                      *
*                                      *
******************++++******************
